47 47 47 54 50 50 50 50 50 55 47 47 54 50 50 50 50 50 50 56 67 56 67 56 50 50 55 47 54 50 52 33 33 67 33 49 55 47 47 47 47 47 47 47 47 47 47 47 47 47 
47 47 47 48 33 68 67 45 45 49 50 50 51 33 45 67 33 67 33 2 3 4 3 2 45 56 49 50 51 45 45 2 2 3 2 78 49 50 55 47 47 47 47 47 47 47 47 47 47 47 
47 54 50 51 2 2 3 2 4 33 67 68 68 2 2 3 4 3 2 6 7 5 7 8 69 69 45 45 45 2 2 14 14 7 14 2 45 45 49 50 50 50 55 47 47 47 47 47 47 47 
47 48 45 45 14 14 7 16 14 2 3 2 2 6 14 7 10 7 8 14 14 14 14 13 14 63 40 41 41 27 14 14 14 14 14 14 2 2 33 67 78 78 46 47 47 47 47 47 47 47 
47 48 4 2 14 14 14 14 14 14 7 14 14 14 14 14 14 14 42 43 43 44 14 14 14 64 39 39 39 27 14 14 42 44 14 5 14 14 69 3 69 69 46 47 47 47 47 47 47 47 
47 48 14 14 14 42 44 14 14 14 14 14 14 14 14 63 14 42 58 47 47 57 44 14 14 64 39 39 39 27 14 14 46 57 43 43 44 14 14 7 14 14 46 47 47 47 47 47 47 47 
47 48 14 14 42 58 48 14 14 14 14 14 42 43 43 62 43 58 47 14 14 14 14 14 14 64 39 39 63 14 14 42 58 47 47 47 57 44 14 10 14 14 46 47 47 47 47 47 47 47 
47 48 14 14 49 55 57 43 43 43 44 14 46 47 47 47 47 14 14 14 14 14 14 14 14 66 39 39 66 14 14 46 47 47 47 47 47 57 44 14 14 14 46 47 47 47 47 47 47 47 
47 48 14 17 29 46 47 47 47 47 57 43 58 47 47 47 14 14 14 14 47 54 50 14 14 67 45 45 67 14 42 58 47 47 47 47 47 47 57 44 14 14 46 47 47 47 47 47 47 47 
50 51 19 82 42 58 47 47 47 47 47 47 47 14 14 14 14 14 47 47 47 48 45 45 14 3 4 4 3 14 46 47 47 47 47 47 47 47 54 51 14 14 46 47 47 47 47 47 47 47 
36 36 36 36 46 47 47 47 47 47 14 47 47 14 14 14 47 47 47 47 47 48 2 2 14 7 14 14 7 14 46 47 54 50 50 50 50 50 51 33 14 14 46 47 47 47 47 47 47 47 
39 39 39 39 46 47 47 47 14 14 14 14 14 14 14 47 47 54 50 50 50 51 19 19 19 19 20 19 19 19 49 50 51 68 68 67 45 45 68 35 14 14 46 47 47 47 47 47 47 47 
39 39 39 39 46 47 47 47 14 14 14 14 14 14 14 14 47 48 45 67 45 56 56 67 56 56 56 67 56 56 45 45 45 4 4 3 4 4 4 14 14 14 46 47 47 47 47 47 47 47 
39 39 39 39 46 47 47 47 14 14 14 14 14 14 14 47 47 48 4 3 4 2 2 3 2 2 2 3 2 2 2 4 4 6 14 7 14 14 14 14 14 42 58 47 47 47 47 47 47 47 
39 39 39 39 46 47 47 14 14 14 14 14 14 14 14 47 47 48 14 7 14 14 14 7 14 14 14 7 14 14 14 14 14 14 14 14 14 14 14 63 14 46 47 47 47 47 47 47 47 47 
39 39 39 42 58 47 47 14 14 14 14 14 14 14 14 47 47 48 14 14 14 14 14 14 14 14 14 14 14 14 14 14 10 14 14 14 14 14 14 64 14 49 55 47 47 47 47 47 47 47 
39 39 42 58 47 47 14 14 14 14 14 14 14 14 47 47 47 48 14 14 14 14 14 14 14 14 14 14 14 14 14 14 14 14 14 14 14 14 14 64 14 33 49 50 55 47 47 47 47 47 
39 39 46 47 47 47 47 47 14 14 14 14 14 14 14 47 54 51 14 14 14 14 14 14 14 14 14 14 14 14 14 14 14 14 14 14 14 14 14 64 14 2 45 45 46 47 47 47 47 47 
39 39 46 47 47 14 14 14 14 14 14 14 14 14 14 14 48 14 14 14 14 14 14 14 14 14 14 14 14 14 14 14 14 14 14 14 14 14 14 64 14 14 2 2 49 55 47 47 47 47 
39 39 49 50 55 47 47 14 14 14 14 14 14 14 14 14 48 14 14 14 14 19 19 19 19 18 19 19 18 18 14 19 19 19 19 18 19 19 19 66 14 14 14 14 45 49 55 47 47 47 
39 39 25 25 49 55 47 47 47 14 14 14 14 14 14 47 57 43 34 14 14 45 45 67 45 45 45 67 78 56 14 33 45 67 45 45 45 67 45 45 14 14 14 14 2 45 49 50 50 50 
39 39 39 39 25 49 50 55 47 47 47 14 14 14 14 47 47 48 14 14 14 4 4 3 4 4 4 3 4 4 14 35 4 3 4 4 4 3 4 4 14 14 63 14 14 2 45 25 25 25 
39 39 39 39 39 25 25 49 50 55 15 14 14 14 14 14 47 48 14 14 14 14 14 7 14 14 14 7 14 14 14 14 14 7 14 14 14 7 14 16 14 14 64 14 14 14 2 39 39 39 
39 39 39 39 39 39 39 25 25 46 14 14 42 44 14 14 14 14 14 14 14 14 14 14 14 14 14 14 14 14 14 16 14 14 14 14 14 14 14 14 14 14 64 14 14 14 22 39 39 39 
39 39 39 39 39 39 39 39 39 46 14 14 46 48 14 14 14 14 14 14 14 14 14 14 14 14 14 14 14 14 14 14 14 14 14 14 14 14 14 14 14 14 64 14 14 14 22 39 39 39 
39 39 39 39 39 39 39 39 39 46 14 14 46 48 14 14 14 14 14 14 14 14 14 14 14 14 14 14 14 14 14 14 14 14 14 14 14 14 14 14 14 14 64 14 14 14 22 39 39 39 
39 39 39 39 39 39 39 39 42 58 47 14 46 48 14 14 14 14 14 14 14 14 14 14 14 14 14 14 14 14 14 14 14 14 14 14 14 14 14 14 14 14 64 14 14 17 82 39 39 39 
39 39 39 39 39 39 39 39 46 47 47 14 46 48 14 14 14 14 14 14 14 14 14 14 14 14 14 14 14 14 14 14 14 14 14 14 14 14 14 14 14 14 66 14 14 22 26 39 39 39 
39 39 39 39 39 39 39 39 46 47 14 14 46 48 14 14 14 14 14 14 14 14 16 14 14 14 14 14 14 14 14 14 14 14 14 14 14 14 14 14 14 14 30 14 13 22 39 39 39 39 
39 39 39 39 39 39 39 39 46 47 14 14 46 48 14 14 14 14 14 14 14 14 14 14 14 14 14 14 14 14 14 14 14 14 14 14 14 14 14 14 14 14 14 14 15 22 39 39 39 39 
39 39 39 39 39 39 42 43 58 47 14 14 46 48 14 14 14 14 14 14 14 14 14 14 14 14 14 14 14 14 70 23 23 23 23 23 23 43 43 43 43 44 14 14 14 22 39 39 39 39 
39 39 39 39 39 42 58 47 47 47 14 14 46 48 14 14 14 14 14 14 14 14 14 14 14 14 14 14 14 14 64 14 14 14 14 14 14 46 47 47 54 51 14 17 18 82 39 39 39 39 
39 39 39 39 42 58 47 47 47 47 14 14 46 48 14 14 14 14 14 14 14 14 14 14 14 14 14 14 14 14 66 82 14 14 14 14 14 46 47 47 48 30 14 22 26 26 39 39 39 39 
39 39 42 43 58 47 47 14 14 14 14 14 46 48 14 14 14 14 14 42 43 43 44 14 14 14 14 14 14 14 30 14 14 14 14 14 42 58 47 54 51 14 17 82 39 39 39 39 39 39 
39 39 46 47 47 14 14 14 14 14 42 43 58 48 14 14 14 14 42 58 47 47 48 14 14 14 14 14 14 14 14 14 14 14 14 42 58 47 47 48 30 14 22 26 39 39 39 39 39 39 
39 39 46 14 14 14 14 14 14 42 58 47 47 57 43 43 43 43 58 47 47 47 48 14 14 14 14 14 14 14 14 14 14 14 42 58 47 47 47 48 14 14 22 39 39 39 39 39 39 39 
39 39 46 47 14 14 14 42 43 58 47 47 47 47 47 47 47 47 47 47 47 47 57 44 14 14 14 14 14 14 14 14 14 14 46 47 47 47 47 48 14 14 22 39 39 39 39 39 39 39 
39 39 46 47 14 14 42 58 47 47 47 47 47 47 47 47 47 47 47 47 47 47 47 48 14 14 14 14 14 14 42 43 43 43 58 47 47 47 47 48 14 14 22 39 39 39 39 39 39 39 
39 39 46 14 14 14 46 47 47 47 47 47 47 47 47 47 47 47 47 47 47 47 47 48 14 14 14 14 14 14 46 47 47 47 47 47 47 47 47 48 14 14 28 30 80 39 39 39 39 39 
39 42 58 6 14 14 46 47 47 47 47 47 54 50 55 47 54 50 55 47 47 47 47 48 14 14 14 16 14 14 46 47 47 47 47 47 54 50 50 51 14 14 14 14 28 30 80 39 39 39 
39 49 55 47 14 14 46 47 47 47 47 47 48 25 49 50 51 25 46 47 47 47 47 48 14 14 14 14 15 14 46 47 47 47 47 54 51 45 67 45 14 14 14 14 14 14 28 80 39 39 
39 25 46 47 14 14 46 54 50 50 50 50 51 39 25 25 25 37 46 47 47 54 50 51 14 14 14 14 14 14 49 50 50 50 50 51 45 4 3 4 14 14 14 14 14 14 14 28 80 39 
39 39 46 47 47 14 46 48 67 45 67 45 45 39 39 39 39 39 46 47 54 51 45 45 14 14 14 13 14 14 45 67 45 45 67 45 4 14 7 14 14 17 19 21 14 14 14 14 22 39 
39 39 49 55 47 47 49 51 3 4 3 2 4 39 39 39 39 39 46 47 48 33 2 2 14 14 14 14 14 14 4 3 4 4 3 4 14 14 14 14 17 82 40 27 14 14 14 14 22 39 
39 39 25 49 55 14 30 30 7 6 8 17 82 39 39 39 39 39 49 50 51 2 14 14 14 14 14 14 14 14 14 7 14 5 7 14 14 17 19 19 82 40 39 27 14 14 14 14 22 39 
39 39 39 25 49 55 14 14 47 14 47 48 25 39 39 39 39 39 33 45 45 27 14 14 17 18 20 19 19 19 19 18 21 14 14 14 17 82 25 25 25 39 39 81 21 14 14 17 82 39 
39 39 39 39 25 49 55 47 47 14 54 51 39 39 39 39 39 39 41 41 41 81 20 19 82 25 25 25 25 25 25 25 81 19 19 19 82 25 37 39 39 39 39 25 81 19 19 82 40 39 
39 39 39 39 39 25 49 50 47 50 51 25 39 39 39 39 39 39 39 39 39 25 25 25 25 39 39 39 39 39 39 39 25 25 36 36 36 37 39 39 39 39 39 39 25 25 36 36 39 39 
39 39 39 39 39 39 25 25 47 25 25 39 39 39 39 39 39 39 39 39 39 39 39 39 39 39 39 39 39 39 39 39 39 39 39 39 39 39 39 39 39 39 39 39 39 39 39 39 39 39 
39 39 39 39 39 39 39 7 7 7 39 39 39 39 39 39 39 39 39 39 39 39 39 39 39 39 39 39 39 39 39 39 39 39 39 39 39 39 39 39 39 39 39 39 39 39 39 39 39 39 
