0 0 0 0 0 0 0 0 0 0 0 0 0 0 0 0 0 0 0 0 0 0 0 0 0 0 0 0 0 0 0 0 0 0 0 0 0 0 0 0 0 0 0 0 0 0 0 0 0 0 
0 0 0 0 0 0 0 0 0 0 0 0 0 0 0 0 0 0 0 0 0 0 0 0 0 0 0 0 0 0 0 0 0 0 0 0 0 0 0 0 0 0 0 0 0 0 0 0 0 0 
0 0 0 0 0 0 0 0 0 0 0 0 0 0 0 0 0 0 0 0 0 0 0 0 0 0 0 0 0 0 0 0 0 0 0 0 0 0 0 0 0 0 0 0 0 0 0 0 0 0 
0 0 0 0 0 0 0 0 0 0 0 0 0 0 0 0 0 0 0 0 0 0 0 0 0 0 0 0 0 0 0 0 0 0 0 0 0 0 0 0 0 0 0 0 0 0 0 0 0 0 
0 0 0 0 0 0 0 0 0 0 0 0 0 0 0 0 0 0 0 0 0 0 0 0 0 0 0 0 0 0 0 0 0 0 0 0 0 0 0 0 0 0 0 0 0 0 0 0 0 0 
0 0 0 0 0 0 0 0 0 0 0 0 0 0 0 0 0 0 0 0 0 0 0 0 0 0 0 0 0 0 0 0 0 0 0 0 0 0 0 0 0 0 0 0 0 0 0 0 0 0 
0 0 0 0 0 0 0 14 7 7 12 13 13 20 11 8 8 8 8 8 8 9 21 13 13 13 13 13 13 20 11 8 8 8 8 8 8 12 13 13 13 13 13 0 0 0 0 0 0 0 
0 0 0 0 0 0 0 14 5 1 9 10 10 11 8 7 7 7 7 7 7 8 12 13 13 20 10 10 10 11 8 7 7 7 7 7 7 9 21 13 13 13 13 0 0 0 0 0 0 0 
0 0 0 0 0 0 0 14 1 1 8 8 8 8 7 1 1 1 1 1 2 7 12 13 13 14 8 8 8 8 7 1 1 1 1 2 1 8 12 13 13 13 13 0 0 0 0 0 0 0 
0 0 0 0 0 0 0 22 17 2 7 7 7 7 1 1 1 1 1 1 1 1 12 13 13 14 7 7 7 7 1 2 1 1 15 17 1 7 9 21 13 13 13 0 0 0 0 0 0 0 
0 0 0 0 0 0 0 13 14 1 1 1 1 1 1 1 2 3 2 1 1 1 12 13 20 11 1 1 1 1 1 1 1 15 23 14 1 1 8 9 21 13 13 0 0 0 0 0 0 0 
0 0 0 0 0 0 0 13 22 16 16 16 16 17 1 1 1 1 1 1 1 1 12 20 11 1 1 2 2 1 1 1 15 23 20 11 8 1 7 8 12 13 13 0 0 0 0 0 0 0 
0 0 0 0 0 0 0 13 13 13 13 13 13 22 17 1 1 1 1 2 1 15 24 11 1 1 1 1 1 1 15 16 23 13 14 8 7 1 1 7 9 21 13 0 0 0 0 0 0 0 
0 0 0 0 0 0 0 13 13 13 13 13 20 10 11 8 8 8 1 8 15 24 11 1 1 1 28 8 15 16 23 13 13 20 11 7 1 2 2 1 8 12 13 0 0 0 0 0 0 0 
0 0 0 0 0 0 0 20 10 10 21 13 14 8 8 7 7 7 1 7 12 14 1 1 1 33 35 7 9 10 21 20 10 11 8 1 2 1 1 1 7 12 13 0 0 0 0 0 0 0 
0 0 0 0 0 0 0 14 8 8 9 10 11 7 7 1 2 2 1 1 12 14 2 2 1 8 8 1 8 8 32 11 8 8 7 1 1 3 1 1 1 12 13 0 0 0 0 0 0 0 
0 0 0 0 0 0 0 14 7 7 8 8 8 1 1 1 26 1 1 1 12 14 1 15 17 7 7 1 7 7 27 8 7 7 1 1 1 1 1 1 1 12 13 0 0 0 0 0 0 0 
0 0 0 0 0 0 0 14 1 2 7 7 7 15 16 16 25 17 1 15 23 14 1 12 14 1 1 1 1 2 8 7 1 1 1 15 17 1 1 1 15 23 13 0 0 0 0 0 0 0 
0 0 0 0 0 0 0 14 1 1 1 1 1 12 13 13 13 14 2 12 13 14 1 9 30 1 2 1 1 1 7 1 1 15 16 23 22 17 1 15 23 13 13 0 0 0 0 0 0 0 
0 0 0 0 0 0 0 14 1 2 1 1 1 12 13 13 13 14 1 32 10 11 1 8 29 1 1 2 1 1 1 1 15 23 13 13 13 14 2 12 13 13 13 0 0 0 0 0 0 0 
0 0 0 0 0 0 0 14 1 1 3 1 1 12 13 13 13 14 1 29 8 8 1 7 31 17 1 1 1 1 15 16 23 13 13 13 20 11 1 9 10 21 13 0 0 0 0 0 0 0 
0 0 0 0 0 0 0 14 1 1 1 1 2 32 10 10 10 11 1 27 7 7 1 1 12 22 16 16 16 16 23 13 13 20 10 10 11 8 1 8 8 12 13 0 0 0 0 0 0 0 
0 0 0 0 0 0 0 22 16 17 1 15 36 35 8 8 8 8 1 8 1 1 1 1 12 13 13 13 13 13 13 20 10 11 8 8 8 7 1 7 7 12 13 0 0 0 0 0 0 0 
0 0 0 0 0 0 0 13 13 14 1 9 11 8 7 7 7 7 1 7 7 7 8 15 23 13 13 13 13 13 13 14 8 8 7 7 7 1 1 1 1 12 13 0 0 0 0 0 0 0 
0 0 0 0 0 0 0 13 13 14 1 8 8 7 1 1 1 1 1 1 1 2 7 12 13 13 13 13 13 13 13 14 7 7 1 1 1 1 3 1 1 12 13 0 0 0 0 0 0 0 
0 0 0 0 0 0 0 13 13 14 1 7 7 1 1 2 1 1 1 1 1 1 1 9 10 10 10 10 10 10 10 11 1 1 2 2 1 1 1 1 1 12 13 0 0 0 0 0 0 0 
0 0 0 0 0 0 0 13 13 14 1 1 1 1 1 1 1 3 1 1 2 1 1 8 8 8 8 8 8 8 8 8 1 1 1 1 1 1 2 1 1 12 13 0 0 0 0 0 0 0 
0 0 0 0 0 0 0 13 13 14 2 1 2 1 1 1 1 1 1 1 1 1 1 7 7 7 7 7 7 7 7 7 1 1 1 1 1 1 2 1 1 12 13 0 0 0 0 0 0 0 
0 0 0 0 0 0 0 13 13 22 16 16 16 17 1 2 2 1 1 1 2 1 1 1 1 1 1 2 2 1 1 1 1 2 1 1 1 15 17 1 1 12 13 0 0 0 0 0 0 0 
0 0 0 0 0 0 0 13 13 13 13 13 13 22 16 16 17 1 1 15 16 16 16 16 16 17 1 15 16 16 16 17 1 1 1 15 16 24 11 1 1 12 13 0 0 0 0 0 0 0 
0 0 0 0 0 0 0 13 13 13 13 13 13 13 13 13 14 1 1 12 13 13 13 13 20 11 1 9 21 13 13 22 16 16 16 23 13 14 1 1 2 12 13 0 0 0 0 0 0 0 
0 0 0 0 0 0 0 13 13 13 13 13 13 13 13 13 14 1 1 12 13 13 13 13 14 8 1 8 12 13 13 13 13 13 13 13 13 22 17 1 1 12 13 0 0 0 0 0 0 0 
0 0 0 0 0 0 0 13 13 13 13 13 13 13 20 10 11 2 1 9 10 21 13 13 14 7 1 7 12 13 13 13 13 13 13 13 13 13 22 16 16 23 13 0 0 0 0 0 0 0 
0 0 0 0 0 0 0 13 13 13 13 13 13 13 14 8 8 2 1 8 8 12 13 13 14 1 1 1 12 13 13 13 13 13 13 13 13 13 13 13 13 13 13 0 0 0 0 0 0 0 
0 0 0 0 0 0 0 13 20 10 10 10 10 10 11 7 7 1 1 7 7 12 13 13 14 1 1 1 12 13 13 13 13 13 13 20 10 10 10 10 10 21 13 0 0 0 0 0 0 0 
0 0 0 0 0 0 0 13 14 8 8 8 8 8 8 1 1 1 1 1 1 12 13 13 22 16 16 16 23 13 13 20 10 10 10 11 8 8 8 8 8 12 13 0 0 0 0 0 0 0 
0 0 0 0 0 0 0 13 14 7 7 7 7 7 7 1 1 1 1 2 1 12 13 13 13 13 13 13 13 13 20 11 8 8 8 8 7 7 7 7 7 12 13 0 0 0 0 0 0 0 
0 0 0 0 0 0 0 20 11 37 38 38 38 38 38 1 2 1 1 1 1 9 10 10 10 10 10 10 10 10 11 8 7 7 7 7 1 1 1 2 1 12 13 0 0 0 0 0 0 0 
0 0 0 0 0 0 0 14 8 2 8 15 16 16 17 1 1 3 1 1 1 8 8 8 8 8 8 8 8 8 8 7 1 1 1 1 1 1 15 17 1 12 13 0 0 0 0 0 0 0 
0 0 0 0 0 0 0 14 7 2 7 12 13 13 14 1 1 2 1 1 1 7 7 7 7 7 7 7 7 7 7 1 1 2 3 1 2 15 23 14 1 12 13 0 0 0 0 0 0 0 
0 0 0 0 0 0 0 14 37 1 39 12 13 13 14 1 1 1 1 1 1 1 2 1 1 1 1 2 1 1 1 1 1 1 1 1 1 12 13 14 1 12 13 0 0 0 0 0 0 0 
0 0 0 0 0 0 0 14 1 6 2 12 13 13 22 16 16 16 16 16 16 16 16 16 16 16 16 16 16 16 16 17 1 2 2 1 1 12 13 14 3 12 13 0 0 0 0 0 0 0 
0 0 0 0 0 0 0 14 1 3 1 12 13 13 13 13 13 13 13 13 13 13 13 13 13 13 13 13 13 13 13 22 16 16 16 16 16 23 13 22 16 23 13 0 0 0 0 0 0 0 
0 0 0 0 0 0 0 22 16 16 16 23 13 13 13 13 13 13 13 13 13 13 13 13 13 13 13 13 13 13 13 13 13 13 13 13 13 13 13 13 13 13 13 0 0 0 0 0 0 0 
0 0 0 0 0 0 0 0 0 0 0 0 0 0 0 0 0 0 0 0 0 0 0 0 0 0 0 0 0 0 0 0 0 0 0 0 0 0 0 0 0 0 0 0 0 0 0 0 0 0 
0 0 0 0 0 0 0 0 0 0 0 0 0 0 0 0 0 0 0 0 0 0 0 0 0 0 0 0 0 0 0 0 0 0 0 0 0 0 0 0 0 0 0 0 0 0 0 0 0 0 
0 0 0 0 0 0 0 0 0 0 0 0 0 0 0 0 0 0 0 0 0 0 0 0 0 0 0 0 0 0 0 0 0 0 0 0 0 0 0 0 0 0 0 0 0 0 0 0 0 0 
0 0 0 0 0 0 0 0 0 0 0 0 0 0 0 0 0 0 0 0 0 0 0 0 0 0 0 0 0 0 0 0 0 0 0 0 0 0 0 0 0 0 0 0 0 0 0 0 0 0 
0 0 0 0 0 0 0 0 0 0 0 0 0 0 0 0 0 0 0 0 0 0 0 0 0 0 0 0 0 0 0 0 0 0 0 0 0 0 0 0 0 0 0 0 0 0 0 0 0 0 
0 0 0 0 0 0 0 0 0 0 0 0 0 0 0 0 0 0 0 0 0 0 0 0 0 0 0 0 0 0 0 0 0 0 0 0 0 0 0 0 0 0 0 0 0 0 0 0 0 0 
