0 0 0 0 0 0 0 0 0 0 0 0 0 0 0 0 0 0 0 0 0 0 0 0 0 0 0 0 0 0 0 0 0 0 0 0 0 0 0 0 0 0 0 0 0 0 0 0 0 0 
0 0 0 0 0 0 0 0 0 0 0 0 0 0 0 0 0 0 0 0 0 0 0 0 0 0 0 0 0 0 0 0 0 0 0 0 0 0 0 0 0 0 0 0 0 0 0 0 0 0 
0 0 0 0 0 0 0 0 0 0 0 0 0 0 0 0 0 0 0 0 0 0 0 0 0 0 0 0 0 0 0 0 0 0 0 0 0 0 0 0 0 0 0 0 0 0 0 0 0 0 
0 0 0 0 0 0 0 0 0 0 0 0 0 0 0 0 0 0 0 0 0 0 0 0 0 0 0 0 0 0 0 0 0 0 0 0 0 0 0 0 0 0 0 0 0 0 0 0 0 0 
0 0 0 0 0 0 0 0 0 0 0 0 0 0 0 0 0 0 0 0 0 0 0 0 0 0 0 0 0 0 0 0 0 0 0 0 0 0 0 0 0 0 0 0 0 0 0 0 0 0 
0 0 0 0 0 0 0 0 0 0 0 0 0 0 0 0 0 0 0 0 0 0 0 0 0 0 0 0 0 0 0 0 0 0 0 0 0 0 0 0 0 0 0 0 0 0 0 0 0 0 
0 0 0 0 0 0 0 13 13 13 13 13 13 13 13 13 13 13 13 13 13 13 13 13 13 13 13 13 13 13 13 13 13 13 13 13 13 13 13 13 13 13 13 0 0 0 0 0 0 0 
0 0 0 0 0 0 0 13 13 13 13 13 13 13 13 13 13 13 13 13 13 13 13 20 10 10 10 21 13 13 13 13 13 13 13 13 13 13 13 13 13 13 13 0 0 0 0 0 0 0 
0 0 0 0 0 0 0 13 13 13 13 13 13 13 13 13 13 13 13 13 13 13 13 14 2 3 2 12 13 13 13 13 13 13 13 13 13 13 13 13 13 13 13 0 0 0 0 0 0 0 
0 0 0 0 0 0 0 13 13 13 13 13 13 13 13 13 13 13 13 13 13 13 13 14 1 1 1 12 13 13 13 13 13 13 13 13 13 13 13 13 13 13 13 0 0 0 0 0 0 0 
0 0 0 0 0 0 0 13 13 13 13 13 13 13 13 13 13 13 13 13 13 13 13 22 17 1 15 23 13 13 13 13 13 13 13 13 13 13 13 13 13 13 13 0 0 0 0 0 0 0 
0 0 0 0 0 0 0 13 13 13 13 13 13 13 13 13 13 13 13 13 13 13 13 13 14 1 12 13 13 13 13 13 13 13 13 13 13 13 13 13 13 13 13 0 0 0 0 0 0 0 
0 0 0 0 0 0 0 13 13 13 13 13 13 13 13 13 13 13 13 13 13 13 13 13 14 1 12 13 13 13 13 13 13 13 13 13 13 13 13 13 13 13 13 0 0 0 0 0 0 0 
0 0 0 0 0 0 0 13 13 13 13 13 13 13 13 13 13 13 13 20 10 10 10 10 11 1 9 10 10 10 21 13 13 13 13 13 13 13 13 13 13 13 13 0 0 0 0 0 0 0 
0 0 0 0 0 0 0 13 13 13 13 13 13 13 13 13 13 20 10 11 8 8 8 8 8 2 8 8 8 8 9 10 21 13 13 13 13 13 13 13 13 13 13 0 0 0 0 0 0 0 
0 0 0 0 0 0 0 13 13 13 13 13 13 13 13 13 20 11 8 8 7 7 7 7 7 1 7 7 7 7 8 8 9 10 21 13 13 13 13 13 13 13 13 0 0 0 0 0 0 0 
0 0 0 0 0 0 0 13 13 13 13 13 13 13 13 20 11 8 7 7 1 1 1 2 1 1 1 1 1 1 7 7 8 8 9 21 13 13 13 13 13 13 13 0 0 0 0 0 0 0 
0 0 0 0 0 0 0 13 13 13 13 13 13 13 20 11 8 7 1 1 1 1 1 1 1 1 1 1 1 1 1 1 7 7 8 12 13 13 13 13 13 13 13 0 0 0 0 0 0 0 
0 0 0 0 0 0 0 13 13 13 13 13 13 20 11 8 7 1 1 1 1 3 1 1 1 1 1 1 3 1 1 1 1 1 7 9 21 13 13 13 13 13 13 0 0 0 0 0 0 0 
0 0 0 0 0 0 0 13 13 13 13 13 13 14 8 7 1 1 1 1 1 1 1 1 1 1 1 1 1 2 1 1 1 1 1 8 12 13 13 13 13 13 13 0 0 0 0 0 0 0 
0 0 0 0 0 0 0 13 13 13 13 13 13 14 7 1 1 1 1 2 1 1 1 1 1 1 1 1 1 2 1 1 1 1 1 7 12 13 13 13 13 13 13 0 0 0 0 0 0 0 
0 0 0 0 0 0 0 13 13 13 13 13 13 14 3 2 1 1 1 1 1 1 1 1 1 2 1 1 1 1 1 1 1 1 1 3 12 13 13 13 13 13 13 0 0 0 0 0 0 0 
0 0 0 0 0 0 0 13 13 13 13 13 13 14 3 1 1 1 1 1 1 1 1 1 1 1 1 1 1 1 1 1 1 1 2 3 12 13 13 13 13 13 13 0 0 0 0 0 0 0 
0 0 0 0 0 0 0 13 13 13 13 13 13 22 17 1 1 1 1 2 1 1 1 1 1 1 1 1 1 1 1 1 1 1 1 1 12 13 13 13 13 13 13 0 0 0 0 0 0 0 
0 0 0 0 0 0 0 13 13 13 13 13 13 13 14 1 1 1 1 1 1 1 1 1 1 1 1 1 1 1 1 1 1 1 1 2 12 13 13 13 13 13 13 0 0 0 0 0 0 0 
0 0 0 0 0 0 0 13 13 13 13 13 13 13 22 17 1 1 1 1 1 1 1 1 1 1 2 1 1 1 1 1 1 1 15 16 23 13 13 13 13 13 13 0 0 0 0 0 0 0 
0 0 0 0 0 0 0 13 13 13 13 13 13 13 13 22 16 17 1 1 3 1 1 1 1 1 1 1 1 1 1 3 1 15 23 13 13 13 13 13 13 13 13 0 0 0 0 0 0 0 
0 0 0 0 0 0 0 13 13 13 13 13 13 13 13 13 13 22 16 17 1 2 1 1 1 1 1 1 1 1 2 1 15 23 13 13 13 13 13 13 13 13 13 0 0 0 0 0 0 0 
0 0 0 0 0 0 0 13 13 13 13 13 13 13 13 13 13 13 13 22 16 16 16 16 17 1 15 16 16 16 16 16 23 13 13 13 13 13 13 13 13 13 13 0 0 0 0 0 0 0 
0 0 0 0 0 0 0 13 13 13 13 13 13 13 13 13 13 13 13 13 13 13 13 13 14 1 12 13 13 13 13 13 13 13 13 13 13 13 13 13 13 13 13 0 0 0 0 0 0 0 
0 0 0 0 0 0 0 13 13 13 13 13 13 13 13 13 13 13 13 13 13 13 13 13 14 2 12 13 13 13 13 13 13 13 13 13 13 13 13 13 13 13 13 0 0 0 0 0 0 0 
0 0 0 0 0 0 0 13 13 13 13 13 13 13 13 13 13 13 13 13 13 13 13 13 14 1 12 13 13 13 13 13 13 13 13 13 13 13 13 13 13 13 13 0 0 0 0 0 0 0 
0 0 0 0 0 0 0 13 13 13 13 13 13 13 13 13 13 13 13 13 13 13 13 13 14 2 12 13 13 13 13 13 13 13 13 13 13 13 13 13 13 13 13 0 0 0 0 0 0 0 
0 0 0 0 0 0 0 13 13 13 13 13 13 13 13 13 13 13 13 13 13 13 13 13 14 1 9 21 13 13 13 13 13 13 13 13 13 13 13 13 13 13 13 0 0 0 0 0 0 0 
0 0 0 0 0 0 0 13 13 13 13 13 13 13 13 13 13 13 13 13 13 13 13 13 14 2 8 12 13 13 13 13 13 13 13 13 13 13 13 13 13 13 13 0 0 0 0 0 0 0 
0 0 0 0 0 0 0 13 13 13 13 13 13 13 13 13 13 13 13 13 13 13 13 13 14 1 7 12 13 13 13 13 13 13 13 13 13 13 13 13 13 13 13 0 0 0 0 0 0 0 
0 0 0 0 0 0 0 13 13 13 13 13 13 13 13 13 13 13 13 13 13 13 13 13 14 1 3 9 21 13 13 13 13 13 13 13 13 13 13 13 13 13 13 0 0 0 0 0 0 0 
0 0 0 0 0 0 0 13 13 13 13 13 13 13 13 13 13 13 13 13 13 13 13 13 14 8 1 8 12 13 13 13 13 13 13 13 13 13 13 13 13 13 13 0 0 0 0 0 0 0 
0 0 0 0 0 0 0 13 13 13 13 13 13 13 13 13 13 13 13 13 13 13 13 13 14 7 1 7 12 13 13 13 13 13 13 13 13 13 13 13 13 13 13 0 0 0 0 0 0 0 
0 0 0 0 0 0 0 13 13 13 13 13 13 13 13 13 13 13 13 13 13 13 13 13 14 2 1 1 12 13 13 13 13 13 13 13 13 13 13 13 13 13 13 0 0 0 0 0 0 0 
0 0 0 0 0 0 0 13 13 13 13 13 13 13 13 13 13 13 13 13 13 13 13 13 14 1 1 1 12 13 13 13 13 13 13 13 13 13 13 13 13 13 13 0 0 0 0 0 0 0 
0 0 0 0 0 0 0 13 13 13 13 13 13 13 13 13 13 13 13 13 13 13 13 13 14 1 6 1 12 13 13 13 13 13 13 13 13 13 13 13 13 13 13 0 0 0 0 0 0 0 
0 0 0 0 0 0 0 13 13 13 13 13 13 13 13 13 13 13 13 13 13 13 13 13 22 16 16 16 23 13 13 13 13 13 13 13 13 13 13 13 13 13 13 0 0 0 0 0 0 0 
0 0 0 0 0 0 0 13 13 13 13 13 13 13 13 13 13 13 13 13 13 13 13 13 13 13 13 13 13 13 13 13 13 13 13 13 13 13 13 13 13 13 13 0 0 0 0 0 0 0 
0 0 0 0 0 0 0 0 0 0 0 0 0 0 0 0 0 0 0 0 0 0 0 0 0 0 0 0 0 0 0 0 0 0 0 0 0 0 0 0 0 0 0 0 0 0 0 0 0 0 
0 0 0 0 0 0 0 0 0 0 0 0 0 0 0 0 0 0 0 0 0 0 0 0 0 0 0 0 0 0 0 0 0 0 0 0 0 0 0 0 0 0 0 0 0 0 0 0 0 0 
0 0 0 0 0 0 0 0 0 0 0 0 0 0 0 0 0 0 0 0 0 0 0 0 0 0 0 0 0 0 0 0 0 0 0 0 0 0 0 0 0 0 0 0 0 0 0 0 0 0 
0 0 0 0 0 0 0 0 0 0 0 0 0 0 0 0 0 0 0 0 0 0 0 0 0 0 0 0 0 0 0 0 0 0 0 0 0 0 0 0 0 0 0 0 0 0 0 0 0 0 
0 0 0 0 0 0 0 0 0 0 0 0 0 0 0 0 0 0 0 0 0 0 0 0 0 0 0 0 0 0 0 0 0 0 0 0 0 0 0 0 0 0 0 0 0 0 0 0 0 0 
0 0 0 0 0 0 0 0 0 0 0 0 0 0 0 0 0 0 0 0 0 0 0 0 0 0 0 0 0 0 0 0 0 0 0 0 0 0 0 0 0 0 0 0 0 0 0 0 0 0 
