39 39 39 39 39 39 39 39 39 39 39 39 39 39 39 39 39 39 39 39 39 39 39 39 39 39 39 39 39 39 39 39 39 39 39 39 39 39 39 39 39 39 39 39 39 39 39 39 39 39 
39 39 39 39 39 39 39 39 39 39 39 39 39 39 39 39 39 39 39 49 54 54 54 48 39 39 39 39 39 39 39 49 54 54 48 39 39 39 39 39 39 39 39 39 39 39 39 39 39 39 
39 39 39 39 49 54 54 48 39 39 39 39 39 39 49 54 54 54 54 58 47 47 47 59 54 48 39 39 39 49 54 58 47 47 59 54 48 39 39 39 39 39 39 39 39 39 39 39 39 39 
39 39 39 49 58 47 47 59 48 39 39 39 39 49 58 47 47 47 47 47 47 47 47 47 47 53 39 39 39 52 47 47 47 47 47 47 59 54 48 39 39 39 39 39 39 39 39 39 39 39 
39 39 49 58 47 47 47 47 59 54 54 54 54 58 47 47 47 47 60 60 60 60 47 47 47 53 39 39 39 52 47 47 60 60 47 47 47 47 59 54 54 48 39 39 39 39 39 39 39 39 
39 39 52 47 47 60 60 47 47 47 47 47 47 47 47 60 47 60 60 60 60 60 60 47 47 53 39 39 39 52 47 47 60 60 60 60 60 47 47 47 47 53 39 39 39 39 39 39 39 39 
39 39 52 47 60 60 60 47 47 47 47 47 60 60 60 60 60 60 60 60 60 60 60 47 47 53 39 39 49 58 47 60 60 60 60 60 60 60 47 47 47 53 39 39 39 39 39 39 39 39 
39 39 52 47 60 60 60 60 60 60 60 47 60 60 60 60 60 60 60 60 60 60 60 60 47 53 39 39 52 47 47 60 60 60 60 60 60 60 60 47 47 53 39 39 39 39 39 39 39 39 
39 39 52 47 47 60 60 60 60 60 60 60 60 60 60 60 60 60 60 60 60 60 60 60 47 53 39 39 52 47 60 60 60 60 60 60 60 60 60 60 47 53 39 39 39 39 39 39 39 39 
39 39 51 57 47 47 60 60 60 60 60 60 60 60 60 60 60 60 60 60 60 60 47 47 47 59 54 54 58 47 60 60 60 60 60 60 60 60 60 60 47 53 39 39 39 39 39 39 39 39 
39 39 39 51 57 47 60 60 60 60 60 60 60 60 60 60 60 60 60 60 60 47 47 47 47 47 47 47 47 47 60 60 47 47 47 60 60 60 60 47 47 53 39 39 39 39 39 39 39 39 
39 39 39 39 52 47 60 60 60 60 60 60 60 60 60 60 60 60 60 60 60 47 47 47 47 47 47 47 47 47 47 60 47 47 47 47 47 47 47 47 47 53 39 39 39 39 39 39 39 39 
39 39 39 39 52 47 47 60 60 60 60 60 60 60 60 60 60 60 47 47 47 47 47 47 47 47 47 47 47 47 47 47 47 47 47 47 47 47 47 47 47 53 39 39 39 39 39 39 39 39 
39 39 39 39 52 47 47 60 60 60 60 60 60 60 60 60 60 60 47 47 49 54 54 54 54 54 54 54 54 54 54 54 54 54 54 54 54 54 54 48 47 53 39 39 39 39 39 39 39 39 
39 39 39 39 52 47 60 60 60 60 60 60 60 60 60 60 60 60 47 47 52 47 47 47 47 47 47 47 47 47 47 47 47 47 47 47 47 47 47 53 47 53 39 39 39 39 39 39 39 39 
39 39 39 49 58 47 60 60 60 60 60 60 60 60 60 60 60 60 47 47 52 47 47 47 47 47 47 47 47 47 47 47 47 47 47 47 47 47 47 53 47 53 39 39 39 39 39 39 39 39 
39 39 49 58 47 47 60 60 60 60 60 60 60 60 60 60 60 60 47 47 52 47 47 47 60 47 47 47 47 47 47 47 47 47 47 47 47 47 47 53 47 53 39 39 39 39 39 39 39 39 
39 39 52 47 47 60 60 60 60 60 60 60 60 60 60 60 60 60 47 47 52 47 47 47 47 47 47 47 47 47 60 47 47 47 47 47 60 47 47 53 47 59 54 48 39 39 39 39 39 39 
39 39 51 57 47 47 60 60 47 60 60 60 60 60 60 60 60 47 47 47 52 47 47 60 47 47 47 47 47 47 60 47 47 47 47 47 47 47 47 53 47 47 47 53 39 39 39 39 39 39 
39 39 39 51 57 47 47 47 47 47 60 60 60 60 60 60 60 47 47 47 52 47 60 60 47 47 47 47 47 47 60 47 47 47 47 47 47 47 47 53 47 60 47 59 48 39 39 39 39 39 
39 39 39 39 51 57 47 47 47 47 47 60 60 60 60 60 60 60 60 47 52 47 47 47 47 47 47 47 47 47 47 47 47 47 47 47 47 47 47 53 47 60 47 47 59 60 39 39 39 39 
39 39 39 39 39 51 55 57 47 47 47 60 60 60 60 60 60 60 47 47 51 55 55 55 55 55 50 47 51 55 55 55 55 55 55 55 55 55 55 50 47 60 60 47 47 59 60 39 39 39 
39 39 39 39 39 39 39 51 55 57 47 60 60 60 60 60 60 60 47 47 47 47 47 47 47 47 47 47 47 47 47 47 47 47 47 47 47 47 47 47 47 47 60 47 47 47 53 39 39 39 
39 39 39 39 39 39 39 39 39 52 47 47 60 60 60 60 60 60 60 60 60 60 60 60 60 47 47 47 60 60 60 47 47 47 47 47 60 60 60 60 60 60 60 60 47 47 53 39 39 39 
39 39 39 39 39 39 39 39 39 52 47 47 47 60 60 60 60 60 60 60 60 60 60 60 47 47 47 47 60 60 60 60 60 60 47 60 60 60 60 60 60 60 60 60 47 47 53 39 39 39 
39 39 39 39 39 39 39 39 39 52 47 47 60 60 60 60 60 60 60 60 60 60 60 60 47 47 47 47 60 60 60 60 60 60 60 60 60 60 60 60 60 60 60 60 47 47 53 39 39 39 
39 39 39 39 39 39 39 39 49 58 47 47 60 60 60 60 60 60 60 60 62 60 60 60 47 47 47 47 60 60 60 60 60 60 60 60 60 60 60 60 60 60 60 60 47 47 53 39 39 39 
39 39 39 39 39 39 39 39 52 47 47 47 60 60 60 60 60 60 60 60 60 60 60 60 47 47 47 60 60 60 60 60 60 60 60 60 60 60 60 60 60 60 60 47 47 56 50 39 39 39 
39 39 39 39 39 39 39 39 52 47 47 47 60 60 60 60 60 60 60 60 60 60 60 60 60 60 47 47 60 60 60 60 60 60 60 60 60 60 60 60 47 47 47 47 60 53 39 39 39 39 
39 39 39 39 39 39 39 39 52 47 60 60 60 60 60 60 60 60 60 60 60 60 60 60 60 60 60 60 60 60 60 60 60 60 60 60 60 60 60 47 47 47 47 47 60 53 39 39 39 39 
39 39 39 39 39 39 49 54 58 47 60 60 60 60 60 60 60 60 60 60 60 60 60 60 60 60 60 60 60 60 60 60 60 60 60 60 60 60 60 60 60 60 47 47 60 53 39 39 39 39 
39 39 39 39 39 49 58 47 47 47 60 60 60 60 60 60 60 60 60 60 60 60 60 60 60 60 60 60 60 60 60 47 47 47 47 47 47 60 60 60 60 60 47 47 60 53 39 39 39 39 
39 39 39 39 49 58 47 47 60 60 60 60 60 60 60 60 60 60 60 60 60 60 60 60 60 60 60 60 60 60 60 47 47 47 47 47 47 60 60 60 60 47 47 56 55 50 39 39 39 39 
39 39 49 54 58 47 47 47 60 60 60 60 60 60 60 60 60 60 60 60 60 60 60 60 60 60 60 60 60 60 47 47 47 47 47 47 60 60 60 60 60 47 47 53 39 39 39 39 39 39 
39 39 52 47 47 47 60 60 60 60 60 60 60 60 60 60 60 60 60 60 60 47 60 60 60 60 60 60 60 60 47 47 47 47 47 60 60 60 60 60 47 47 47 53 39 39 39 39 39 39 
39 39 52 47 47 60 60 60 60 60 60 60 60 60 60 60 60 60 60 47 47 47 47 47 60 60 60 60 60 60 47 47 47 47 60 60 60 60 60 60 47 47 56 50 39 39 39 39 39 39 
39 39 52 47 47 60 60 60 60 60 60 47 47 47 60 60 60 47 47 47 47 47 47 47 47 60 60 60 60 60 47 47 47 47 60 60 60 60 60 60 47 47 53 39 39 39 39 39 39 39 
39 39 52 47 60 60 60 47 47 47 47 47 47 47 60 47 47 47 47 47 47 47 47 47 47 60 60 60 60 60 60 47 60 60 60 60 60 60 60 60 60 47 53 39 39 39 39 39 39 39 
39 39 52 47 60 60 60 47 47 56 55 55 57 47 47 47 47 47 47 47 56 55 55 57 47 47 60 60 60 60 60 60 60 60 60 60 60 60 60 60 60 47 59 54 48 39 39 39 39 39 
39 49 50 47 60 60 47 47 56 50 39 39 51 55 57 47 56 55 55 55 50 39 39 52 47 47 60 60 60 60 60 60 60 60 60 60 60 60 60 60 47 47 47 47 59 54 48 39 39 39 
39 51 57 47 60 60 47 56 50 39 39 39 39 39 51 55 50 39 39 39 39 39 39 52 47 47 47 60 60 60 60 60 60 60 60 60 60 60 60 60 47 47 47 47 47 47 59 48 39 39 
39 39 52 47 60 60 47 53 39 39 39 39 39 39 39 39 39 39 39 39 39 49 54 58 47 47 47 60 60 60 60 60 60 60 60 60 60 60 60 60 47 47 47 47 47 47 47 59 48 39 
39 39 52 47 47 60 47 53 39 39 39 39 39 39 39 39 39 39 39 49 54 58 47 47 47 47 47 60 60 60 60 60 60 60 60 60 60 47 47 47 47 47 47 47 47 47 47 47 53 39 
39 39 51 57 47 47 47 59 54 54 54 54 48 39 39 39 39 39 49 58 47 47 47 47 47 47 47 47 47 60 60 60 60 60 60 60 47 47 47 47 47 56 55 57 47 47 47 47 53 39 
39 39 39 51 57 47 47 47 47 47 47 56 50 39 39 39 39 39 52 47 47 47 47 47 47 47 47 47 47 47 60 47 47 47 60 60 47 47 47 47 56 50 39 52 47 47 47 47 53 39 
39 39 39 39 51 57 47 47 60 47 47 53 39 39 39 39 39 39 51 57 47 47 47 47 47 47 47 47 47 47 47 47 47 47 47 47 47 47 56 55 50 39 39 52 47 47 47 47 53 39 
39 39 39 39 39 51 57 47 47 47 56 50 39 39 39 39 39 39 39 51 57 47 47 47 56 55 55 55 55 55 55 55 57 47 47 47 47 56 50 39 39 39 39 51 57 47 47 56 50 39 
39 39 39 39 39 39 51 50 47 51 50 39 39 39 39 39 39 39 39 39 51 55 55 55 50 39 39 39 39 39 39 39 51 55 55 55 55 50 39 39 39 39 39 39 51 55 55 50 39 39 
39 39 39 39 39 39 39 39 7 39 39 39 39 39 39 39 39 39 39 39 39 39 39 39 39 39 39 39 39 39 39 39 39 39 39 39 39 39 39 39 39 39 39 39 39 39 39 39 39 39 
39 39 39 39 39 39 39 7 7 7 39 39 39 39 39 39 39 39 39 39 39 39 39 39 39 39 39 39 39 39 39 39 39 39 39 39 39 39 39 39 39 39 39 39 39 39 39 39 39 39 
